a bit	một chút, một tí
a couple	một cặp, một đôi
a few	một ít, một vài
abandon	bỏ, ruồng bỏ
abandoned	bị bỏ rơi, bị ruồng bỏ
ability	khả năng, năng lực
able	có năng lực, có tài
about	khoảng, về
above	ở trên, lên trên
abroad	ở, ra nước ngoài
absent	vắng mặt
absolute	tuyệt đối hoàn toàn
absorb	thu hút, hấp dẫn
abuse	lộng hành, lạm dụng
academic	thuộc học viện, đh, viện hàn lâm
accent	trọng âm, dấu trọng âm
accept	chấp nhận, chấp thuận
acceptable	có thể chấp nhận
access	lối, cửa, đường vào
accident	tai nạn, rủi ro
accidental	tình cờ, bất ngờ
accommodation	sự thích nghi, điều tiết
accopany	đi theo, đi cùng
according to	theo như
account	tài khoản, kế toán
accurate	đúng đắn, chính xác
accuse	tố cáo, buộc tội
achieve	đạt được, giành được
achievement	thành tích, thành tựu
acid	axit
acknowledge	công nhận, thừa nhận
acquire	dành được, đạt được
across	qua, ngang qua
act	hành động, hành vi
action	hành vi, động tác
active	tích cực hoạt động, nhanh nhẹn
actor	diễn viên nam
actress	diễn viên nữ
actual	thực tế, có thật
adapt	tra, lắp vào
add	cộng, thêm vào
addition	tính cộng, phép cộng
additional	thêm vào, tăng thêm
address	địa chỉ, đề địa chỉ
adequate	đầy, đầy đủ
adequately	tương xứng, thỏa đáng
adjust	sửa lại cho đúng, điều chỉnh
admiration	sự khâm phục,người kp, thán phục
admire	khâm phục, thán phục
admit	nhận vào, cho vào, kết hợp
adopt	nhận làm con nuôi, bố mẹ nuôi
adult	người lớn, người trưởng thành; trưởng thành
advance	sự tiến bộ, tiến lên; đưa lên, đề xuất
advanced	tiên tiến, tiến bộ, cấp cao
advantage	sự thuận lợi, lợi ích, lợi thế
adventure	sự phiêu lưu, mạo hiểm
advertise	báo cho biết, báo cho biết trước
advertisement	quảng cáo
advertisement	quảng cáo
advertising	sự quảng cáo, nghề quảng cáo
advice	lời khuyên, lời chỉ bảo
advise	khuyên, khuyên bảo, răn bảo
affair	việc
affect	làm ảnh hưởng, tác động đến
affection	sự ảnh hưởng, sự tác động
afford	có thể, có đủ khả năng, điều kiện (làm gì)
afraid	sợ, sợ hãi, hoảng sợ
after	sau, đằng sau, sau khi
afternoon	buổi chiều
afterwards	sau này, về sau, rồi thì, sau đấy
again	lại, nữa, lần nữa
against	chống lại, phản đối
age	tuổi
aged	già đi (v)
agency	tác dụng, lực; môi giới, trung gian
agent	đại lý, tác nhân
aggressive	xâm lược, hung hăng (US: xông xáo)
ago	trước đây
agree	đồng ý, tán thành
agreement	sự đồng ý, tán thành; hiệp định, hợp đồng
ahead	trước, về phía trước
aid	sự giúp đỡ; thêm vào, phụ vào
aim	sự nhắm (bắn), mục tiêu, ý định; nhắm, tập trung, hướng vào
air	không khí, bầu không khí, không gian
aircraft	máy bay, khí cầu
airport	sân bay, phi trường
alarm	báo động, báo nguy
alarmed	lo sợ, hoảng hốt, sợ hãi
alarming	làm lo sợ, làm hốt hoảng, làm sợ hãi
alcohol	rượu cồn
alcoholic	rượu; người nghiện rượu
alive	sống, vẫn còn sống, còn tồn tại
all	tất cả
all right	tốt, ổn, khỏe mạnh; được
allied	liên minh, đồng minh, thông gia
allow	cho phép, để cho
ally	nước đồng minh, liên minh; liên kết, lien minh, kết thông gia
almost	hầu như, gần như
alone	cô đơn, một mình
along	dọc theo, theo; theo chiều dài, suốt theo
alongside	sát cạnh, kế bên, dọc theo
aloud	lớn tiếng, to tiếng
alphabet	bảng chữ cái, bước đầu, điều cơ bản
alphabetical	thuộc bảng chứ cái
alphabetically	theo thứ tự abc
already	đã, rồi, đã... rồi
also	cũng, cũng vậy, cũng thế
alter	thay đổi, biến đổi, sửa đổi
alternative	sự lựa chọn; lựa chọn
alternatively	như một sự lựa chọn
although	mặc dù, dẫu cho
altogether	hoàn toàn, hầu như; nói chung
always	luôn luôn
amaze	làm ngạc nhiên, làm sửng sốt
amazed	kinh ngạc, sửng sốt
amazing	kinh ngạc, sửng sốt
ambition	hoài bão, khát vọng
ambulance	xe cứu thương, xe cấp cứu
among	giữa, ở giữa
amount	số lượng, số nhiều; lên tới (money)
amuse	làm cho vui, thích, làm buồn cười
amused	vui thích
amusing	vui thích
analyse	phân tích
analysis	sự phân tích
ancient	xưa, cổ
and	và
anger	sự tức giận, sự giận dữ
angle	góc
angrily	tức giận, giận dữ
angry	giận, tức giận
animal	động vật, thú vật
ankle	mắt cá chân
anniversary	ngày, lễ kỉ niệm
announce	báo, thông báo
annoy	chọc tức, làm bực mình; làm phiền, quẫy nhiễu
annoyed	bị khó chịu, bực mình, bị quấy rầy
annoying	chọc tức, làm bực mình; làm phiền, quẫy nhiễu
annual	hàng năm, từng năm
annually	hàng năm, từng năm
another	khác
answer	sự trả lời; trả lời
anti- prefix	chống lại
anticipate	thấy trước, chặn trước, lường trước
anxiety	mối lo âu, sự lo lắng
anxious	lo âu, lo lắng, băn khoăn
anxiously	lo âu, lo lắng, băn khoăn
any	một người, vật nào đó; bất cứ; một chút nào, tí nào
anyone	người nào, bất cứ ai
anything	việc gì, vật gì; bất cứ việc gì, vật gì
anyway	thế nào cũng được, dù sao chăng nữa
anywhere	bất cứ chỗ nào, bất cứ nơi đâu
apart	về một bên, qua một bên
apart from	ngoài...ra
apart from	ngoài... ra
apartment	căn phòng, căn buồng
apologize	xin lỗi, tạ lỗi
apparent	rõ ràng, rành mạch; bề ngoài, có vẻ
apparently	nhìn bên ngoài, hình như
appeal	sự kêu gọi, lời kêu gọi; kêu gọi, cầu khẩn
appear	xuất hiện, hiện ra, trình diện
appearance	sự xuất hiện, sự trình diện
apple	quả táo
application	sự gắn vào, vật gắn vào; sự chuyên cần, chuyên tâm
apply	gắn vào, ghép vào, áp dụng vào
appoint	bổ nhiệm, chỉ định, chọn
appointment	sự bổ nhiệm, người được bổ nhiệm
appreciate	thấy rõ; nhận thức
approach	đến gần, lại gần; sự đến gần, sự lại gần
appropriate	thích hợp, thích đáng
approval	sự tán thành, đồng ý, sự chấp thuận
approve	tán thành, đồng ý, chấp thuận
approving	tán thành, đồng ý, chấp thuận
approximate	giống với, giống hệt với
approximately	khoảng chừng, độ chừng
april	tháng Tư
area	diện tích, bề mặt
argue	chứng tỏ, chỉ rõ
argument	lý lẽ
arise	xuất hiện, nảy ra, nảy sinh ra
arm	cánh tay; vũ trang, trang bị (vũ khí)
armed	vũ trang
arms	vũ khí, binh giới, binh khí
army	quân đội
around	xung quanh, vòng quanh
arrange	sắp xếp, sắp đặt, sửa soạn
arrangement	sự sắp xếp, sắp đặt, sự sửa soạn
arrest	bắt giữ, sự bắt giữ
arrival	sự đến, sự tới nơi
arrive	đến, tới nơi
arrow	tên, mũi tên
art	nghệ thuật, mỹ thuật
article	bài báo, đề mục
artificial	nhân tạo
artificially	nhân tạo
artist	nghệ sĩ
artistic	thuộc nghệ thuật, thuộc mỹ thuật
as	như (as you know...)
ashamed	ngượng, xấu hổ
aside	về một bên, sang một bên
aside from	ngoài ra, trừ ra
ask	hỏi
asleep	ngủ, đang ngủ
aspect	vẻ bề ngoài, diện mạo
assist	giúp, giúp đỡ; tham dự, có mặt
assistance	sự giúp đỡ
assistant	người giúp đỡ, người phụ tá; giúp đỡ, phụ tá
associate	kết giao, liên kết, kết hợp, cho cộng tác
associated with	liên kết với
association	sự kết hợp, sự liên kết
assume	mang, khoác, có, lấy (cái vẻ, tính chất...)
assure	đảm bảo, cam đoan
atmosphere	khí quyển
atom	nguyên tử
attach	gắn, dán, trói, buộc
attached	gắn bó
attack	sự tấn công, sự công kích; tấn công, công kích
attempt	sự cố gắng, sự thử; cố gắng, thử
attempted	cố gắng, thử
attend	dự, có mặt
attention	sự chú ý
attitude	thái độ, quan điểm
attorney	người được ủy quyền
attract	thu hút, hấp dẫn
attraction	sự hút, sức hút
attractive	thu hút, có duyên, lôi cuốn
audience	thính, khan giả
august	tháng Tám
aunt	cô, dì
author	tác giả
authority	uy quyền, quyền lực
automatic	tự động
automatically	một cách tự động
autumn	mùa thu (US: mùa thu là fall)
available	có thể dùng được, có giá trị, hiệu lực
average	trung bình, số trung bình, mức trung bình
avoid	tránh, tránh xa
awake	đánh thức, làm thức dậy
award	phần thưởng; tặng, thưởng
aware	biết, nhận thức, nhận thức thấy
away	xa, xa cách, rời xa, đi xa
awful	oai nghiêm, dễ sợ
awfully	tàn khốc, khủng khiếp
awkward	vụng về, lung túng
awkwardly	vụng về, lung túng
back	lưng, về phía sau, trở lại
background	phía sau; nền
backward	về phía sau, lùi lại
bacteria	vi khuẩn
bad	xấu, tồi
bad-tempered	xấu tính, dễ nổi cáu
badly	xấu, tồi
bag	bao, túi, cặp xách
baggage	hành lý
bake	nung, nướng bằng lò
balance	cái cân; làm cho cân bằng, tương xứng
ball	quả bóng
ban	cấm, cấm chỉ; sự cấm
band	băng, đai, nẹp
bandage	dải băng; băng bó
bank	bờ (sông...) , đê
bar	quán bán rượu
bargain	sự mặc cả, sự giao kèo mua bán
barrier	đặt chướng ngại vật
base	cơ sở, cơ bản, nền móng; đặt tên, đặt cơ sở trên cái gì
based on	dựa trên
basic	cơ bản, cơ sở
basically	cơ bản, về cơ bản
basis	nền tảng, cơ sở
bath	sự tắm
bathroom	buồng tắm, nhà vệ sinh
battery	pin, ắc quy
battle	trận đánh, chiến thuật
bay	gian (nhà), nhịp (cầu), chuồng (ngựa); bays: vòng nguyệt quế
be called	được gọi, bị gọi
beach	bãi biển
beak	mỏ chim
bear	mang, cầm, vác, đeo, ôm
beard	râu
beat	tiếng đập, sự đập; đánh đập, đấm
beautiful	đẹp
beautifully	tốt đẹp, đáng hài lòng
beauty	vẻ đẹp, cái đẹp; người đẹp
because	bởi vì, vì
because of	vì, do bởi
become	trở thành, trở nên
bed	cái giường
bedroom	phòng ngủ
beef	thịt bò
beer	rượu bia
before	trước, đằng trước
begin	bắt đầu, khởi đầu
beginning	phần đầu, lúc bắt đầu, lúc khởi đầu
behalf	sự thay mặt
behave	đối xử, ăn ở, cư xử
behaviour	danh từ của behave
behind	sau, ở đằng sau
belief	lòng tin, đức tin, sự tin tưởng
believe	tin, tin tưởng
bell	cái chuông, tiếng chuông
belong	thuộc về, của, thuộc quyền sở hữu
below	ở dưới, dưới thấp, phía dưới
belt	dây lưng, thắt lưng
bend	chỗ rẽ, chỗ uốn; khuỷu tay; cúi xuống, uốn cong
beneath	ở dưới, dưới thấp
benefit	lợi, lợi ích; giúp ích, làm lợi cho
bent	khiếu, sở thích, khuynh hướng
beside	bên cạnh, so với
bet	đánh cuộc, cá cược; sự đánh cuộc
betting	sự đánh cuộc
between	giữa, ở giữa
beyond	ở xa, phía bên kia
bicycle	xe đạp
bid	đặt giá, trả giá; sự đặt giá, sự trả giá
big	to, lớn
bill	hóa đơn, giấy bạc
bin	thùng, thùng đựng rượu
biology	sinh vật học
bird	chim
birth	sự ra đời, sự sinh đẻ
birthday	ngày sinh, sinh nhật
biscuit	bánh quy
bit	bit/ miếng, mảnh
bite	cắn, ngoạm; sự cắn, sự ngoạm
bitter	đắng; đắng cay, chua xót
bitterly	đắng, đắng cay, chua xót
black	đen; màu đen
blade	lưỡi (dao, kiếm); lá (cỏ, cây); mái (chèo); cánh (chong chóng)
blame	khiển trách, mắng trách; sự khiển trách, sự mắng trách
blank	trống, để trắng; sự trống rỗng
blankly	ngây ra, không có thần
blind	đui, mù
block	khối, tảng (đá); làm ngăn cản, ngăn chặn
blonde	hoe vàng, mái tóc hoe vàng
blood	máu, huyết; sự tàn sát, chem giết
blow	nở hoa; sự nở hoa
blue	xanh, màu xanh
board	tấm ván; lát ván, lót ván
boat	tàu, thuyền
body	thân thể, thân xác
boil	sôi, luộc
bomb	quả bom; oánh bom, thả bom
bone	xương
book	sách; ghi chép
boot	giày ống
border	bờ, mép, vỉa, lề (đường)
bore	buồn chán, buồn tẻ
bored	buồn chán
boring	buồn chán
born	sinh, đẻ
borrow	vay, mượn
boss	ông chủ, thủ trưởng
both	cả hai
bother	làm phiền, quấy rầy, làm bực mình
bottle	chai, lọ
bottom	phần dưới cùng, thấp nhất; cuối, cuối cùng
bound	nhất định, chắc chắn
bowl	cái bát
box	hộp, thùng
boy	con trai, thiếu niên
boyfriend	bạn trai
brain	óc não; đầu óc, trí não
branch	ngành; nhành cây, nhánh song, ngả đường
brand	nhãn (hàng hóa)
brave	gan dạ, can đảm
bread	bánh mỳ
break	bẻ gãy, đập vỡ; sự gãy, sự vỡ
breakfast	bữa điểm tâm, bữa sáng
breast	ngực, vú
breath	hơi thở, hơi
breathe	hít, thở
breathing	sự hô hấp, sự thở
breed	nuôi dưỡng, chăm sóc, giáo dục; sinh đẻ; nòi giống
brick	gạch
bridge	cái cầu
brief	ngắn, gọn, vắn tắt
briefly	ngắn, gọn, vắn tắt, tóm tắt
bright	sáng, sáng chói
brightly	sáng chói, tươi
brilliant	tỏa sáng, rực rỡ, chói lọi
bring	mang, cầm , xách lại
broad	rộng
broadcast	tung ra khắp nơi,truyền rộng rãi; phát thanh, quảng bá
broadly	rộng, rộng rãi
broken	bị gãy, bị vỡ
brother	anh, em trai
brown	nâu, màu nâu
brush	bàn chải; chải, quét
bubble	bong bóng, bọt, tăm
budget	ngân sách
build	xây dựng
building	sự xây dựng, công trình xây dựng; tòa nhà binđinh
bullet	đạn (súng trường, súng lục)
bunch	búi, chùm, bó, cụm, buồng; bầy, đàn (AME)
burn	đốt, đốt cháy, thắp, nung, thiêu
burnt	bị đốt, bị cháy, khê; rám nắng, sạm (da)
burst	nổ, nổ tung (bom, đạn); nổ, vỡ (bong bóng); háo hức
bury	chôn cất, mai táng
bus	xe buýt
bush	bụi cây, bụi rậm
business	việc buôn bán, thương mại, kinh doanh
businessman	thương nhân
busy	bận, bận rộn
but	nhưng
butter	bơ
button	cái nút, cái khuy, cúc
buy	mua
buyer	người mua
by	bai/ bởi, bằng
bye	bai/ tạm biệt
cabinet	tủ có nhiều ngăn đựng đồ
cable	dây cáp
cake	bánh ngọt
calculate	tính toán
calculation	sự tính toán
call	gọi; tiếng kêu, tiếng gọi
calm	yên lặng, làm dịu đi; sự yên lặng, sự êm ả
calmly	yên lặng, êm ả; bình tĩnh, điềm tĩnh
camera	máy ảnh
camp	trại, chỗ cắm trại; cắm trại, hạ trại
campaign	chiến dịch, cuộc vận động
camping	sự cắm trại
can modal	có thể; nhà tù, nhà giam, bình, ca đựng
cancel	hủy bỏ, xóa bỏ
cancer	bệnh ung thư
candidate	người ứng cử, thí sinh, người dự thi
candy	kẹo
cannot	không thể
cap	mũ lưỡi trai, mũ vải
capable	có tài, có năng lực; có khả năng, cả gan
capacity	năng lực, khả năng tiếp thu, năng suất
capital	thủ đô, tiền vốn; chủ yếu, chính yếu, cơ bản
captain	người cầm đầu, người chỉ huy, thủ lĩnh
capture	bắt giữ, bắt; sự bắt giữ, sự bị bắt
car	xe hơi
card	thẻ, thiếp
cardboard	bìa cứng, các tông
care	sự chăm sóc, chăm nom; chăm sóc
care for	trông nom, chăm sóc
career	nghề nghiệp, sự nghiệp
careful	cẩn thận, cẩn trọng, biết giữ gìn
carefully	cẩn thận, chu đáo
careless	sơ suất, cầu thả
carelessly	cẩu thả, bất cẩn
carpet	tấm thảm, thảm (cỏ)
carrot	củ cà rốt
carry	mang, vác, khuân chở
case	vỏ, ngăn, túi
cash	tiền, tiền mặt
cast	quăng, ném, thả, đánh gục; sự quăng, sự ném (lưới), sự thả (neo)
castle	thành trì, thành quách
cat	con mèo
catch	bắt lấy, nắm lấy, tóm lấy, chộp lấy
category	hạng, loại; phạm trù
cause	nguyên nhân, nguyên do; gây ra, gây nên
cease	dừng, ngừng, ngớt, thôi, hết, tạnh
ceiling	trần nhà
celebrate	kỷ niệm, làm lễ kỷ niệm; tán dương, ca tụng
celebration	sự kỷ niệm, lễ kỷ niệm; sự tán dương, sự ca tụng
cell	ô, ngăn
cellphone	điện thoại di động
cent	đồng xu (bằng 1/100 đô la)
cent	đồng xu (=1/100 đô la)
centimetre	xen ti met
centimetre	xen ti mét
central	trung tâm, ở giữa, trung ương
centre	điểm giữa, trung tâm, trung ương
century	thế kỷ
ceremony	nghi thức, nghi lễ
certain	chắc chắn
certainly	chắc chắn, nhất định
certificate	giấy chứng nhận, bằng, chứng chỉ
chain	dây, xích; xính lại, trói lại
chair	ghế
chairman/chairwoman	chủ tịch, chủ tọa
challenge	sự thử thách, sự thách thức; thách thức, thử thách
chamber	buồng, phòng, buồng ngủ
chance	sự may mắn
change	thay đổi, sự thay đổi, sự biến đổi
channel	(TV, radio), eo biển
chapter	chương (sách)
character	tính cách, đặc tính, nhân vật
characteristic	riêng, riêng biệt, đặc trưng, đặc tính, đặc điểm
charge	nhiệm vụ, bổn phận, trách nhiệm; giao nhiệm vụ, giao việc
charity	lòng từ thiện, lòng nhân đức; sự bố thí
chart	đồ thị, biểu đồ; vẽ đồ thị, lập biểu đồ
chase	săn bắt; sự săn bắt
chat	nói chuyện, tán gẫu; chuyện phiếm, chuyện gẫu
cheap	rẻ
cheaply	rẻ, rẻ tiền
cheat	lừa, lừa đảo; trò lừa đảo, trò gian lận
check	kiểm tra; sự kiểm tra
cheek	má
cheerful	vui mừng, phấn khởi, hồ hởi
cheerfully	vui vẻ, phấn khởi
cheese	pho mát
chemical	thuộc hóa học; chất hóa học, hóa chất
chemist	nhà hóa học
chemistry	hóa học, môn hóa học, ngành hóa học
cheque	séc
chest	tủ, rương, hòm
chew	nhai, ngẫm nghĩ
chicken	gà, gà con, thịt gà
chief	trọng yếu, chính yếu; thủ lĩnh, lãnh tụ, người đứng đầu, xếp
child	đứa bé, đứa trẻ
chin	cằm
chip	vỏ bào, mảnh vỡ, chỗ sứt, mẻ
chocolate	sô cô la
choice	sự lựa chọn
choose	chọn, lựa chọn
chop	chặt, đốn, chẻ
church	nhà thờ
cigarette	điếu thuốc lá
cinema	rạp xi nê, rạp chiếu bóng
circle	đường tròn, hình tròn
circumstance	hoàn cảnh, trường hợp, tình huống
citizen	người thành thị
city	thành phố
civil	(thuộc) công dân
claim	đòi hỏi, yêu sách; sự đòi hỏi, sự yêu sách, sự thỉnh cầu
clap	vỗ, vỗ tay; tiếng nổ, tiếng vỗ tay
class	lớp học
classic	cổ điển, kinh điển
classroom	lớp học, phòng học
clean	sạch, sạch sẽ;
clear	lau chùi, quét dọn
clearly	rõ ràng, sáng sủa
clerk	thư ký, linh mục, mục sư
clever	lanh lợi, thông minh. tài giỏi, khéo léo
click	làm thành tiếng lách cách; tiếng lách cách, cú nhắp (chuột)
client	khách hàng
climate	khí hậu, thời tiết
climb	leo, trèo
climbing	sự leo trèo
clock	đồng hồ
close	đóng kín, chật chội, che đậy
close	đóng, khép, kết thúc, chấm dứt
closed	bảo thủ, không cởi mở, khép kín
closely	chặt chẽ, kỹ lưỡng, tỉ mỉ
closet	buồng, phòng để đồ, phòng kho
cloth	vải, khăn trải bàn, áo thầy tu
clothes	quần áo
clothing	quần áo, y phục
cloud	mây, đám mây
club	câu lạc bộ; gậy, dùi cui
coach	huấn luyện viên
coal	than đá
coast	sự lao dốc; bờ biển
coat	áo choàng
code	mật mã, luật, điều lệ
coffee	cà phê
coin	tiền kim loại
cold	lạnh, sự lạnh lẽo, lạnh nhạt
coldly	lạnh nhạt, hờ hững, vô tâm
collapse	đổ, sụp đổ; sự đổ nát, sự sụp đổ
colleague	bạn đồng nghiệp
collect	sưu tập, tập trung lại
collection	sự sưu tập, sự tụ họp
college	trường cao đẳng, trường đại học
colour	màu sắc; tô màu
coloured	mang màu sắc, có màu sắc
column	cột , mục (báo)
combination	sự kết hợp, sự phối hợp
combine	kết hợp, phối hợp
come	đến, tới, đi đến, đi tới
comedy	hài kịch
comfort	sự an ủi, khuyên giải, lời động viên, sự an nhàn; dỗ dành, an ủi
comfortable	thoải mái, tiện nghi, đầy đủ
comfortably	dễ chịu, thoải mái, tiện nghi, ấm cúng
command	ra lệnh, chỉ huy; lệnh, mệnh lệnh, quyền ra lệnh, quyền
comment	lời bình luận, lời chú giải; bình luận, phê bình, chú thích, dẫn giải
commercial	buôn bán, thương mại
commission	hội đồng, ủyban,sự ủy nhiệm,sự ủythác; ủy nhiệm, ủy thác
commit	giao, gửi, ủy nhiệm, ủy thác; tống giam, bỏ tù
commitment	sự phạm tội, sự tận tụy, tận tâm
committee	ủy ban
common	công, công cộng, thông thường, phổ biến
commonly	thông thường, bình thường
communicate	truyền, truyền đạt; giao thiệp, liên lạc
communication	sự giao tiếp, liên lạc, sự truyền đạt, truyền tin
community	dân chúng, nhân dân
company	công ty
compare	so sánh, đối chiếu
comparison	sự so sánh
compete	đua tranh, ganh đua, cạnh tranh
competition	sự cạnh tranh, cuộc thi, cuộc thi đấu
competitive	cạnh tranh, đua tranh
complain	phàn nàn, kêu ca
complaint	lời than phiền, than thở; sự khiếu nại, đơn kiện
complete	hoàn thành, xong;
completely	hoàn thành, đầy đủ, trọn vẹn
complex	phức tạp, rắc rối
complicate	làm phức tạp, rắc rối
complicated	phức tạp, rắc rối
computer	máy tính
concentrate	tập trung
concentration	sự tập trung, nơi tập trung
concept	khái niệm
concern	liên quan, dính líu tới; sự liên quan, sự dính líu tới
concerned	có liên quan, có dính líu
concerning	bâng khuâng, ái ngại
concert	buổi hòa nhạc
conclude	kết luận, kết thúc, chấm dứt (công việc)
conclusion	sự kết thúc, sự kết luận, phần kết luận
concrete	bằng bê tông; bê tông
condition	điều kiện, tình cảnh, tình thế
conduct	điều khiển, chỉ đạo, chỉ huy;sự điều khiển, chỉ huy
conference	hội nghị, sự bàn bạc
confidence	lòng tin tưởng, sự tin cậy
confident	tin tưởng, tin cậy, tự tin
confidently	tự tin
confine	giam giữ, hạn chế
confined	hạn chế, giới hạn
confirm	xác nhận, chứng thực
conflictn	xungđột,vachạm;sựxungđột,sựvachạm
confront	đối mặt, đối diện, đối chiếu
confuse	làm lộn xộn, xáo trộn
confused	bối rối, lúng túng, ngượng
confusing	khó hiểu, gây bối rối
confusion	sự lộn xộn, sự rối loạn
congratulations	sự chúc mừng, khen ngợi; lời chúc mừng, khen ngợi (s)
congress	đại hội, hội nghị, Quốc hội
connect	kết nối, nối
connection	sự kết nối, sự giao kết
conscious	tỉnh táo, có ý thức, biết rõ
consequence	kết quả, hậu quả
conservative	thận trọng, dè dặt, bảo thủ
consider	cân nhắc, xem xét; để ý, quan tâm, lưu ý đến
considerable	lớn lao, to tát, đáng kể
considerably	đáng kể, lớn lao, nhiều
consideration	sự cân nhắc, sự xem xét, sự để ý, sự quan tâm
consist of	gồm có
constant	kiên trì, bền lòng
constantly	kiên định
construct	xây dựng
construction	sự xây dựng
consult	tra cứu, tham khảo, thăm dò, hỏi ý kiến
consumer	người tiêu dùng
contact	sự liên lạc, sự giao thiệp; tiếp xúc
contain	bao hàm, chứa đựng, bao gồm
container	cái đựng, chứa; công te nơ
contemporary	đương thời, đương đại
content	nội dung, sự hài lòng
contest	cuộc thi, trận đấu, cuộc tranh luận, cuộc chiến đấu, chiến tranh
context	văn cảnh, khung cảnh, phạm vi
continent	lục địa, đại lục (lục địa Bắc Mỹ)
continue	tiếp tục, làm tiếp
continuous	liên tục, liên tiếp
continuously	liên tục, liên tiếp
contract	hợp đồng, sự ký hợp đồng; ký kết
contrast	sự tương phản; làm tương phản, làm trái
contrasting	tương phản
contribute	đóng góp, ghóp phần
contribution	sự đóng góp, sự góp phần
control	sự điều khiển, quyền hành, quyền lực, quyền chỉ huy
controlled	được điều khiển, được kiểm tra
convenient	tiện lợi, thuận lợi, thích hợp
convention	hội nghị, hiệp định, quy ước
conventional	quy ước
conversation	cuộc đàm thoại, cuộc trò chuyện
convert	đổi, biến đổi
convince	làm cho tin, thuyết phục; làm cho nhận thức thấy
cook	nấu ăn, người nấu ăn
cooker	lò, bếp, nồi nấu
cookie	bánh quy
cooking	sự nấu ăn, cách nấu ăn
cool	mát mẻ, điềm tĩnh; làm mát,
cope	đối phó, đương đầu
copy	bản sao, bản chép lại; sự sao chép; sao chép, bắt chước
core	nòng cốt, hạt nhân; đáy lòng
corner	góc (tường, nhà, phố...)
correct	đúng, chính xác; sửa, sửa chữa
correctly	đúng, chính xác
cost	giá, chi phí; trả giá, phải trả
cottage	nhà tranh
cotton	bông, chỉ, sợi
cough	ho, sự ho, tiếng hoa
coughing	ho
could	có thể
could	có khả năng
council	hội đồng
count	đếm, tính
counter	quầy hàng, quầy thu tiền, máy đếm
country	nước, quốc gia, đất nước
countryside	miền quê, miền nông thôn
county	hạt, tỉnh
couple	đôi, cặp; đôi vợ chồng, cặp nam nữ
courage	sự can đảm, sự dũng cảm, dũng khí
course	tiến trình, quá trình diễn tiến; sân chạy đua
court	sân, sân (tennis...), tòa án, quan tòa, phiên tòa
cousin	anh em họ
cover	bao bọc, che phủ; vỏ, vỏ bọc
covered	có mái che, kín đáo
covering	sự bao bọc, sự che phủ, cái bao, bọc
cow	con bò cái
crack	cừ, xuất sắc; làm nứt, làm vỡ, nứt nẻ, rạn nứt
cracked	rạn, nứt
craft	nghề, nghề thủ công
crash	vải thô; sự rơi (máy bay), sự phá sản, sụp đổ; phá tan tành, phá vụn
crazy	điên, mất trí
cream	kem
create	sáng tạo, tạo nên
creature	sinh vật, loài vật
credit	sự tin, lòng tin, danh tiếng; tiền gửi ngân hàng
credit card	thẻ tín dụng
crime	tội, tội ác, tội phạm
criminal	có tội, phạm tội; kẻ phạm tội, tội phạm
crisis	sự khủng hoảng, cơn khủng hoảng
crisp	giòn
criterion	tiêu chuẩn
critical	phê bình, phê phán; khó tính
criticism	sự phê bình, sự phê phán, lời phê bình, lời phê phán
criticize	phê bình, phê phán, chỉ trích
crop	vụ mùa
cross	cây Thánh Giá, nỗi thống khổ; sự băng qua; băng qua, vượt qua
crowd	đám đông
crowded	kraudid/ đông đúc
crown	vương miện, vua, ngai vàng; đỉnh cao nhất
crucial	quyết định, cốt yếu, chủ yếu
cruel	độc ác, dữ tợn, tàn nhẫn
crush	ép, vắt, đè nát, đè bẹp
cry	khóc, kêu la; sự khóc, tiếng khóc, sự kêu la
cultural	(thuộc) văn hóa
culture	văn hóa, sự mở mang, sự giáo dục
cup	tách, chén
cupboard	1 loại tủ có ngăn
curb	kiềm chế, nén lại, hạn chế
cure	chữa trị, điều trị; cách chữa bệnh, cách điều trị; thuốc
curious	ham muốn, tò mò, lạ lùng
curiously	tò mò, hiếu kỳ, lạ kỳ
curl	quăn, xoắn, uốn quăn, làm xoắn; sự uốn quăn
curly	quăn, xoắn
current	hiện hành, phổ biến, hiện nay; dòng (nước), luống (gió)
currently	hiện thời, hiện nay
curtain	màn (cửa, rạp hát, khói, sương)
curve	đường cong, đường vòng; cong, uốn cong, bẻ cong
curved	cong
custom	phong tục, tục lệ, thói quen, tập quán
customer	khách hàng
customs	thuế nhập khẩu, hải quan
cut	cắt, chặt; sự cắt
cycle	chu kỳ, chu trình, vòng; quay vòng theo chu kỳ, đi xe đạp
cycling	sự đi xe đạp
dad	bố, cha
daily	hàng ngày
damage	mối hạn, điều hại, sự thiệt hại; làm hư hại, làm hỏng, gây
damp	ẩm, ẩm ướt, ẩm thấp
dance	sự nhảy múa, sự khiêu vũ; nhảy múa, khiêu vũ
dancer	diễn viên múa, người nhảy múa
dancing	sự nhảy múa, sự khiêu vũ
danger	sự nguy hiểm, mối hiểm nghèo; nguy cơ, mối đe dọa
dangerous	nguy hiểm
dare	dám, dám đương đầu với; thách
dark	tối, tối tăm; bóng tối, ám muội
data	số liệu, dữ liệu
date	ngày, kỳ, kỳ hạn, thời kỳ, thời đại; đề ngày tháng, ghi niên hiệu
daughter	con gái
day	ngày, ban ngày
dead	chết, tắt
deaf	điếc, làm thinh, làm ngơ
deal	phân phát, phân phối; sự giao dịch, thỏa thuận mua bán
deal with	giải quyết
dear	thân, thân yêu, thân mến; kính thưa, thưa
death	sự chết, cái chết
debate	cuộc tranh luận, cuộc tranh cãi; tranh luận, bàn cãi
debt	nợ
decade	thập kỷ, bộ mười, nhóm mười
decay	tình trạng suy tàn, suy sụp, tình trạng đổ nát
december	tháng mười hai, tháng Chạp
decide	quyết định, giải quyết, phân xử
decision	sự quyết định, sự giải quyết, sự phân xử
declare	tuyên bố, công bố
decline	sự suy tàn, sự suy sụp; suy sụp, suy tàn
decorate	trang hoàng, trang trí
decoration	sự trang hoàng, đồ trang hoàng, trang trí
decorative	để trang hoàng, để trang trí, để làm cảnh
decrease	giảm bớt, làm suy giảm, sự giảm đi, sự giảm sút
deep	sâu, khó lường, bí ẩn
deeply	sâu, sâu xa, sâu sắc
defeat	đánh thắng, đánh bại; sự thất bại (1 kế hoạch), sự tiêu tan (hy vọng..)
defence	cái để bảo vệ, vật để chống đỡ, sự che chở
defend	che chở, bảo vệ, bào chữa
define	định nghĩa
definite	xác định, định rõ, rõ ràng
definitely	rạch ròi, dứt khoát
definition	sự định nghĩa, lời định nghĩa
degree	mức độ, trình độ; bằng cấp; độ
delay	sự chậm trễ, sự trì hoãn, sự cản trở; làm chậm trễ
deliberate	thận trọng, có tính toán, chủ tâm, có suy nghĩ cân nhắc
deliberately	thận trọng, có suy nghĩ cân nhắc
delicate	thanh nhã, thanh tú, tế nhị, khó xử
delight	sự vui thích, sự vui sướng, điều thích thú; làm vui thích, làm say mê
delighted	vui mừng, hài lòng
deliver	cứu khỏi, thoát khỏi, bày tỏ, giãi bày
delivery	sự phân phát, sự phân phối, sự giao hàng; sự bày tỏ, phát biếu
demand	sự đòi hỏi, sự yêu cầu; đòi hỏi, yêu cầu
demonstrate	chứng minh, giải thích; bày tỏ, biểu lộ
dentist	nha sĩ
deny	từ chối, phản đối, phủ nhận
department	cục, sở, ty, ban, khoa; gian hàng, khu bày hàng
departure	sự rời khỏi, sự đi, sự khởi hành
depend	phụ thuộc, tùy thuộc; dựa vào, ỷ vào, trông mong vào
deposit	vật gửi, tiền gửi, tiền đặt cọc; gửi, đặt cọc
depress	làm chán nản, làm phiền muộn; làm suy giảm
depressed	chán nản, thất vọng, phiền muộn; suy yếu, đình trệ
depressing	làm chán nản làm thát vọng, làm trì trệ
depth	chiều sâu, độ dày
derive	nhận được từ, lấy được từ; xuất phát từ, bắt nguồn, chuyển hóa từ (from)
describe	diễn tả, miêu tả, mô tả
description	sự mô tả, sự tả, sự miêu tả
desert	sa mạc; công lao, giá trị; rời bỏ, bỏ trốn
deserted	hoang vắng, không người ở
deserve	đáng, xứng đáng
design	sự thiết kế, kế hoạch, đề cương. phác thảo; phác họa, thiết kế
desire	ước muốn; thèm muốn, ao ước
desk	bàn (học sinh, viết, làm việc)
desperate	liều mạng, liều lĩnh; tuyệt vọng
desperately	liều lĩnh, liều mạng
despite	dù, mặc dù, bất chấp
destroy	phá, phá hoại, phá huỷ, tiêu diệt, triệt phá
destruction	sự phá hoại, sự phá hủy, sự tiêu diệt
detail	chi tiết
detailed	cặn kẽ, tỉ mỉ, nhiều chi tiết
determination	sự xác định, sự định rõ; sự quyết định
determine	xác định, định rõ; quyết định
determined	đã được xác định, đã được xác định rõ
develop	phát triển, mở rộng; trình bày, bày tỏ
development	sự phát triển, sự trình bày, sự bày tỏ
device	kế sách; thiết bị, dụng cụ, máy móc
devote	hiến dâng, dành hết cho
devoted	hiến cho, dâng cho, dành cho; hết lòng, nhiệt tình
diagram	biểu đồ
diamond	kim cương
diary	sổ nhật ký; lịch ghi nhớ
dictionary	từ điển
die	chết, từ trần, hy sinh
diet	chế độ ăn uống, chế độ ăn kiêng
difference	sự khác nhau
different	khác, khác biệt, khác nhau
differently	khác, khác biệt, khác nhau
difficult	khó, khó khăn, gay go
difficulty	sự khó khăn, nỗi khó khăn, điều cản trở
dig	đào bới, xới
dinner	bữa trưa, chiều
direct	trực tiếp, thẳng, thẳng thắn; gửi, viết cho ai, điều khiển
direction	sự điều khiển, sự chỉ huy
directly	trực tiếp, thẳng
director	giám đốc, người điều khiển, chỉ huy
dirt	đồ bẩn thỉu, đồ dơ bẩn, vật rác rưởi
dirty	bẩn thỉu, dơ bẩn
disabled	bất lực, không có khă năng
disadvantage	sự bất lợi, sự thiệt hại
disagree	bất đồng, không đồng ý, khác, không giống; không hợp
disagreement	sự bất đồng, sự không đồng ý, sự khác nhau
disappear	biến mất, biến đi
disappoint	không làm thỏa ước nguyện, ý mong đợi; thất ước, làm thất bại
disappointed	thất vọng
disappointing	làm chán ngán, làm thất vọng
disappointment	sự chán ngán, sự thất vọng
disapproval	sự phản đổi, sự không tán thành
disapprove	không tán thành, phản đối, chê
disapproving	phản đối
disaster	tai họa, thảm họa
disc	đĩa
discipline	kỷ luật
discount	sự bớt giá, sự chiết khấu, tiền bớt, chiết khấu
discover	khám phá, phát hiện ra, nhận ra
discovery	sự khám phá, sự tìm ra, sự phát hiện ra
discuss	thảo luận, tranh luận
discussion	sự thảo luận, sự tranh luận
disease	căn bệnh, bệnh tật
disgust	làm ghê tởm, làm kinh tởm, làm phẫn nộ
disgusted	chán ghét, phẫn nộ
disgusting	làm ghê tởm, kinh tởm
dish	đĩa (đựng thức ăn)
dishonest	bất lương, không thành thật
dishonestly	bất lương, không lương thiện
disk	đĩa, đĩa hát
dislike	sự không ưa, không thích, sự ghét
dismiss	giải tán (quân đội, đám đông); sa thải (người làm)
display	bày tỏ, phô trương, trưng bày; sự bày ra, phô bày, trưng bày
dissolve	tan rã, phân hủy, giải tán
distance	khoảng cách, tầm xa
distinguish	phân biệt, nhận ra, nghe ra
distribute	phân bổ, phân phối, sắp xếp, phân loại
distribution	sự phân bổ, sự phân phối, phân phát, sự sắp xếp
district	huyện, quận
disturb	làm mất yên tĩnh, làm náo động, quấy rầy
disturbing	xáo trộn
divide	chia, chia ra, phân ra
division	sự chia, sự phân chia, sự phân loại
divorce	sự ly dị
divorced	đã ly dị
do	làm
doctor	bác sĩ y khoa, tiến sĩ
document	văn kiện, tài liệu, tư liệu
dog	chó
dollar	đô la Mỹ
domestic	vật nuôi trong nhà, (thuộc) nội trợ, quốc nội
dominate	chiếm ưu thế, có ảnh hưởng, chi phối; kiềm chế
door	cửa, cửa ra vào
dot	chấm nhỏ, điểm; của hồi môn
double	đôi, hai, kép; cái gấp đôi, lượng gấp đôi; làm gấp
doubt	sự nghi ngờ, sự ngờ vực; nghi ngờ, ngờ vực
down	xuống
downstairs	ở dưới nhà, ở tầng dưới; xống gác; tầng dưới
downward	xuống, đi xuống
downwards	xuống, đi xuống
dozen	tá (12)
draft	bản phác thảo, sơ đồ thiết kế; phác thảo, thiết kế
drag	lôi kéo, kéo lê
drama	kịch, tuồng
dramatic	như kịch, như đóng kịch, thích hợp với sân khấu
dramatically	đột ngột
draw	vẽ, kéo
drawer	người vẽ, người kéo
drawing	bản vẽ, bức vẽ, sự kéo
dream	giấc mơ, mơ
dress	quần áo, mặc (quần áo), ăn mặc
dressed	cách ăn mặc
drink	đồ uống; uống
drive	lái , đua xe; cuộc đua xe (điều khiển)
driver	người lái xe
driving	sự lái xe, cuộc đua xe
drop	chảy nhỏ giọt, rơi, rớt; giọt (nước, máu...)
drug	thuốc, dược phẩm; ma túy
drugstore	hiệu thuốc, cửa hàng dược phẩm
drum	cái trống, tiếng trống
drunk	say rượu
dry	khô, cạn; làm khô, sấy khô
due	đến kỳ hạn (trả nợ); xứng đáng, thích đáng
due	tại, nhờ có
dull	chậm hiểu, ngu đần
dump	đổ rác; đống rác, nơi đổ rác
during	trong lúc, trong thời gian
dust	bụi, rác; rắc (bụi, phấn), quét bụi, phủi bụi
duty	sự tôn kính, kính trọng; bồn phận, trách nhiệm
dying	sự chết
e.g	Viết tắt của cụm từ La tinh exempli gratia (for example)
each	mỗi
each other	nhau, lẫn nhau
ear	tai
early	sớm
earn	kiếm (tiền), giành (phần thưởng)
earth	đất, trái đất
ease	sự thanh thản, sự thoải mái; làm thanh thản, làm yên tâm, làm dễ chịu
easily	dễ dàng
east	hướng đông, phía đông, (thuộc) đông, ở phía đông
eastern	đông
easy	dễ dàng, dễ tính, ung dung
eat	ăn
economic	(thuộc) Kinh tế
economy	sự tiết kiệm, sự quản lý kinh tế
edge	lưỡi, cạnh sắc
edition	nhà xuất bản, sự xuất bản
editor	người thu thập và xuất bản, chủ bút
educate	giáo dục, cho ăn học; rèn luyện
educated	được giáo dục, được đào tạo
education	sự giáo dục, sự rèn luyện (kỹ năng)
effect	hiệu ứng, hiệu quả, kết quả
effective	có kết quả, có hiệu lực
effectively	có kết quả, có hiệu lực
efficient	có hiệu lực, có hiệu quả
efficiently	có hiệu quả, hiệu nghiệm
effort	sự cố gắng, sự nỗ lực
egg	trứng
either	mỗi, một; cũng phải thế
elbow	khuỷu tay
elderly	có tuổi, cao tuổi
elect	bầu, quyết định
election	sự bầu cử, cuộc tuyển cử
electric	(thuộc) điện, có điện, phát điện
electrical	(thuộc) điện
electricity	điện, điện lực; điện lực học
electronic	(thuộc) điện tử
elegant	thanh lịch, tao nhã
element	yếu tố, nguyên tố
elevator	máy nâng, thang máy
else	khác, nữa; nếu không
elsewhere	ở một nơi nào khác
email	thư điện tử; gửi thư điện tử
embarrass	lúng túng, làm ngượng nghịu; làm rắc rối, gây khó khăn
embarrassed	lúng túng, bối rối, ngượng; mang nợ
embarrassing	làm lúng túng, ngăn trở
embarrassment	sự lúng túng, sự bối rối
emerge	nổi lên, hiện ra; nổi bật lên
emergency	tình trạng khẩn cấp
emotion	xự xúc động, sự cảm động, mối xác cảm
emotional	cảm động, xúc động, xúc cảm; dễ cảm động, dễ xúc cảm
emotionally	xúc động
emphasis	sự nhấn mạnh, tầm quan trọng
emphasize	nhấn mạnh, làm nổi bật
empire	đế chế, đế quốc
employ	dùng, thuê ai làm gì
employee	người lao động, người làm công
employer	chủ, người sử dụng lao động
employment	sự thuê mướn
empty	trống, rỗng; đổ, dốc; uống, làm cạn
enable	làm cho có thể, có khả năng; cho phép ai làm gì
encounter	chạm chán, bắt gặp; sự chạm trán, sự bắt gặp
encourage	động viên, ủng hộ, giúp đỡ, làm can đảm, mạnh dạn
encouragement	niềm cổ vũ, động viên, khuyến khích, sự làm can đảm
end	giới hạn, sự kết thúc; kết thúc, chấm dứt
ending	sự kết thúc, sự chấm dứt; phần cuối, kết cục
enemy	kẻ thù, quân địch
energy	năng lượng, nghị lực, sinh lực
engage	hứa hẹn, cam kết, đính ước
engaged	đã đính ước, đã hứa hôn; đã có người
engine	 máy, động cơ
engineer	kỹ sư
engineering	nghề kỹ sư, công việc của kỹ sư
enjoy	thưởng thức, thích thú cái gì, được hưởng, có được
enjoyable	thú vị, thích thú
enjoyment	sự thích thú, sự có được, được hưởng
enormous	to lớn, khổng lồ
enough	đủ
enquiry	sự điều tra, sự thẩm vấn
ensure	bảo đảm, chắc chắn
enter	đi vào, gia nhập
entertain	giải trí, tiếp đón, chiêu đãi
entertainer	người quản trò, người tiếp đãi, chiêu đãi
entertaining	giải trí
entertainment	sự giải trí, sự tiếp đãi, chiêu đãi
enthusiasm	sự hăng hái, sự nhiệt tình
enthusiastic	hăng hái, say mê, nhiệt tình
entire	toàn thể, toàn bộ
entirely	toàn vẹn, trọn vẹn, toàn bộ
entitle	cho tiêu đề, cho tên (sách); cho quyền làm gì
entrance	sự đi vào, sự nhậm chức
entry	sự ghi vào sổ sách, sự đi vào, sự tiếp nhận (pháp lý)
envelope	phong bì
environment	môi trường, hoàn cảnh xung quanh
environmental	thuộc về môi trường
equal	ngang, bằng; người ngang hàng, ngang tài, sức; bằng,
equally	bằng nhau, ngang bằng
equipment	trang, thiết bị
equivalent	tương đương; từ, vật tương đương
error	lỗi, sự sai sót, sai lầm
escape	trốn thoát, thoát khỏi; sự trốn thoát, lỗi thoát
especially	đặc biệt là, nhất là
essay	bài tiểu luận
essential	bản chất, thực chất, cốt yếu; yếu tố cần thiết
essentially	về bản chất, về cơ bản
establish	lập, thành lập
estate	tài sản, di sản, bất động sản
estimate	sự ước lượng, đánh giá; ước lượng, đánh giá
etc	vân vân
euro	đơn vị tiền tệ của liên minh châu Âu
even	ngay cả, ngay, lại còn; bằng phẳng, điềm đạm, ngang bằng
evening	buổi chiều, tối
event	sự việc, sự kiện
eventually	cuối cùng
ever adv	từng, từ trước tới giờ
every	mỗi, mọi
everyone	mọi người
everything	mọi vật, mọi thứ
everywhere	mọi nơi
evidence	điều hiển nhiên, điều rõ ràng
evil	xấu, ác; điều xấu, điều ác, điều tai hại
ex- prefix	tiền tố chỉ bên ngoài
exact	chính xác, đúng
exactly	chính xác, đúng đắn
exaggerate	cường điệu, phóng đại
exaggerated	cường điệu, phòng đại
exam	viết tắt của Examination (xem nghĩa phía dưới)
examination	sự thi cử, kỳ thi
examine	thẩm tra, khám xét, hỏi han (thí sinh)
example	thí dụ, ví dụ
excellent	xuất sắc, xuất chúng
except	trừ ra, không kể; trừ phi
exception	sự trừ ra, sự loại ra
exchange	trao đổi; sự trao đổi
excite	kích thích, kích động
excited	bị kích thích, bị kích động
excitement	sự kích thích, sự kích động
exciting	hứng thú, thú vị
exclude	ngăn chạn, loại trừ
excluding	ngoài ra, trừ ra
excuse	lời xin lỗi, bào chữa; xin lỗi, tha thứ, tha lỗi
executiven	sựthihành,chấphành;(thuộc)sựthihành,chấphành
exercise	bài tập, sự thi hành, sự thực hiện; làm, thi hành, thực hiện
exhibit	trưng bày, triển lãm; vật trưng bày, vật triển lãm
exhibition	cuộc triển lãm, trưng bày
exist	tồn tại, sống
existence	sự tồn tại, sự sống
exit	lỗi ra, sự đi ra, thoát ra
expand	mở rộng, phát triển, nở, giãn ra
expect	chờ đợi, mong ngóng; liệu trước
expectation	sự mong chờ, sự chờ đợi
expected	được chờ đợi, được hy vọng
expense	chi phí
expensive	đắt
experience	kinh nghiệm; trải qua, nếm mùi
experienced	có kinh nghiệm, từng trải, giàu kinh nghiệm
experiment	cuộc thínghiệm;thínghiệm
expert	chuyên gia; chuyên môn, thành thạo
explain	giải nghĩa, giải thích
explanation	sự giải nghĩa, giải thích
explode	đập tan (hy vọng...), làm nổ, nổ
explore	thăm dò, thám hiểm
explosion	sự nổ, sự phát triển ồ ạt
export	xuất khẩu; hàng xuất khẩu, sự xuất khẩu
expose	trưng bày, phơi bày
express	diễn tả, biểu lộ, bày tỏ; nhanh, tốc hành
expression	sự diễn tả, sự bày tỏ, biểu lộ, sự diễn đạt
extend	giơ, duỗi ra (tay, chân..); kéo dài (thời gian..), dành cho, gửi lời
extension	sự giơ, duỗi; sự kéo dài, sự dành cho, gửi lời
extensive	rộng rãi, bao quát
extent	quy mô, phạm vi
extra	thêm, phụ, ngoại; thứ thêm, phụ
extraordinary	đặc biệt, lạ thường, khác thường
extreme	vô cùng, khắc nghiệt, quá khích, cực đoan; sự quá khích
extremely	vô cùng, cực độ
eye	mắt
face	mặt, thể diện; đương đầu, đối phó, đối mặt
facility	điều kiện dễ dàng, sự dễ dàng, thuận lợi
fact	việc, sự việc, sự kiện
factor	nhân tố
factory	nhà máy, xí nghiệp, xưởng
fail	sai, thất bại
failure	sự thất bại, người thất bại
faint	nhút nhát, yếu ớt
faintly	nhút nhát, yếu ớt
fair	hợp lý, công bằng; thuận lợi
fairly	hợp lý, công bằng
faith	sự tin tưởng, tin cậy; niềm tin, vật đảm bảo
faithful	trung thành, chung thủy, trung thực
faithfully	trung thành, chung thủy, trung thực
fall	rơi, ngã, sự rơi, ngã
fall asleep	ngủ thiếp đi
fall over	ngã lộn nhào, bị đổ
false	sai, nhầm, giả dối
fame	tên tuổi, danh tiếng
familiar	thân thiết, quen thộc
family	gia đình, thuộc gia đình
famous	nổi tiếng
fan	người hâm mộ
fancy	tưởng tượng, cho, nghĩ rằng; tưởng tượng
far	xa
farm	trang trại
farmer	nông dân, người chủ trại
farming	công việc trồng trọt, đồng áng
fashion	mốt, thời trang
fashionable	đúng mốt, hợp thời trang
fast	nhanh
fasten	buộc, trói
fat	béo, béo bở; mỡ, chất béo
father	cha (bố)
faucet	vòi (ở thùng rượu....)
fault	sự thiết sót, sai sót
favour	thiện ý, sự quý mến; sự đồng ý; sự chiếu cố
favourite	được ưa thích; người (vật) được ưa thích
fear	sự sợ hãi, e sợ; sợ, lo ngại
feather	lông chim
feature	nét đặt biệt, điểm đặc trưng; mô tả nét đặc biệt, đặc trưng của...
february	tháng 2
federal	liên bang
fee	tiền thù lao, học phí
feed	cho ăn, nuôi
feel	cảm thấy
feeling	sự cảm thấy, cảm giác
fellow	anh chàng (đang yêu), đồng chí
female	thuộc giống cái; giống cái
fence	hàng rào
festival	lễ hội, đại hội liên hoan
fetch	tìm về, đem về; làm bực mình; làm say mê, quyến rũ
fever	cơn sốt, bệnh sốt
few 	ít,vài; một ít, một vài
field	cánh đồng, bãi chiến trường
fight	đấu tranh, chiến đấu; sự đấu tranh, cuộc chiến đấu
fighting	sự chiến đấu, sự đấu tranh
figure	hình dáng, nhân vật; hình dung, miêu tả
file	hồ sơ, tài liệu
fill	làm đấy, lấp kín
film	phim, được dựng thành phim
final	cuối cùng, cuộc đấu chung kết
finally	cuối cùng, sau cùng
finance	tài chính; tài trợ, cấp vốn
financial	thuộc (tài chính)
find	tìm, tìm thấy
find out	khám phá, tìm ra
fine	tốt, giỏi
finely	đẹp đẽ, tế nhị, cao thượng
finger	ngón tay
finish	kết thúc, hoàn thành; sự kết thúc, phần cuối
finished	hoàn tất, hoàn thành
fire	lửa; đốt cháy
firm	hãng, công ty; chắc, kiên quyết, vũng vàng, mạnh mẽ
firmly	vững chắc, kiên quyết
fish	cá, món cá; câu cá, bắt cá
fishing	sự câu cá, sự đánh cá
fit	hợp, vừa; thích hợp, xứng đáng
fix	đóng, gắn, lắp; sửa chữa, sửa sang
fixed	đứng yên, bất động
flag	quốc kỳ
flame	ngọn lửa
flash	loé sáng, vụt sáng; ánh sáng lóe lên, đèn nháy
flat 	bằng phẳng, bẹt, nhẵn; dãy phòng, căn phòng, mặt phẳng
flavour	 vị, mùi; cho gia vị, làm tăng thêm mùi vị
flesh 	thịt
flight	sự bỏ chạy, rút chạy; sự bay, chuyến bay
float	 nổi, trôi, lơ lửng
further	xa hơn nữa; thêm nữa
give birth (to)	sinh ra
go bad	bẩn thỉu, thối, hỏng
good	tốt, khỏe
in addition	thêm vào
in advance	trước, sớm
in case (of)	nếu......
in charge of	phụ trách
in common	sự chung, của chung
in control (of)	trong sự điều khiển của
in detail	tường tận, tỉ mỉ
in exchange (for)	trong việc trao đổi về
in the end	cuối cùng, về sau
mother	mẹ
of course	dĩ nhiên
on behalf of sb	thay mặt cho ai, nhân danh ai
on board	trên tàu thủy
on sb’s behalf	nhân danh cá nhân ai
pay attention (to)	chú ý tới
take advantage of	lợi dụng
take care (of)	sự giữ gìn
unable	không có năng lực
unacceptable	không thể chấp nhận
uncertain	thiếu chính xác, không chắc chắn
uncomfortable	bất tiện, khó chịu, không thoải mái
unconscious	bất tỉnh, không có ý thức, không biết rõ
uncontrolled	không bị điều khiển, không bị kiểm tra, không bị hạn chế
under control	dưới sự điều khiển của
undo	tháo, gỡ; xóa bỏ, hủy bỏ
unemployed	thất nghiệp; không dùng, không sử dụng được
unemployment	sự thất nghiệp, nạn thất nghiệp
unexpected	bất ngờ, gây ngạc nhiên
unexpectedly	bất ngờ, gây ngạc nhiên
unfair	gian lận, không công bằng; bất lợi
unfairly	gian lận, không công bằng; bất lợi
yours faithfully	bạn chân thành
